S F F F F
F F T F F
F T F T F
F F F F F
F F F F G
